8 17
|---------------|
|F..|...........|
|F.-|.@.....|...|
|..F............|
|.......P.|.....|
|...............|
|..P....-|....F.|
|---------------|